---------------
---------------
---------------
---------------
---------------
---------------
---------------
---------------
---------------
---------------
---------------
---------------
---------------
---------------
---------------
---------------
---------------
---------------
---------------
---M-------M---
---------------
---H-------H---
---H-------H---
---H-------H---
cccB-------Bccc
--------------H
H--------------
--------------H
--------------H
--------------H
--------------H
cccB-------cccB
---------------
---------------
---------------
u--------------
---------------
---------------
---------------
---------------
---------------
---------------
---------------
----------F----
----------F----
----------F----
---------------
---------------
---------------
---------------
cccc-BccccScccc
H-------------H
cccc--ccccSccc-
U----------cccc
---------------
---------------
-------U-------
-------S---cccc
---------------
--------------U
---------c-c---
ccc------c-c---
---------d-----
cc-------------
eecc----------c
ceeec-------cde
-cecB-----cceef
dfec------Bcecc
fecB------Mceff
ec-----Hceeceec
ec----ccccBccd-
c----ceec------
------cc-------
cc-----U-------
eed----S-------
ec----------BB-
fec---------BB-
ffe------------
fec-----------B
feeec-------cce
ffecc------ceef
eecTT------ceff
cc---------Tcef
------------ccf
-------------cf
------c------cf
-----ccc----cef
----cceec---cef
-----Bcc----ccf
------Uc----cef
-----------ceff
-----------cefe
-----------ceee
------------cBc
---------------
cc------------U
-c----cc-------
--U---UBU------
--------------U
--------------B
------B--------
---------------
---------------
---------------
u--------------
---------------
-------L-------
---------------
---------------
---------------
--L------------
---------------
---------L-----
---------------
---------------
---------------
---------------
---------------
---------------
---------------
---------------
---------------
---------------
---------------
---------------
---------------
---------------
---------------
---------------
---------------
-c-------------
-c-----p-------
-c-------------
